18 20 1
BBBBBBBBBBBBBBBBBB
BBBBPPPPPPPPPPPPBB
BBBBPBBBBBBBBBBPBB
BBBPPBBBBBPPPPBPBB
BBBPBBBSPPPBBRPPBB
BBBPBBBPBBBPPPBPBB
BBBPBBBPBBBPBBBPBB
BBBPBBBPBBBPBBBPBB
BBBPBBBPBBBPPPPPPB
BPAPPBBPBBBPBBBBPB
BPBBPBBPPPPPPPPBPB
BPPPPBBBBBBBBBPBPB
BBBBPBBBBPPPPBPBPB
BBBBPBBPPPBBVPPBPB
BBBBPBBPBPBBBBPPPB
BBBBPBBPBPPPPPPPBB
BBBBPBBPBBBBBBBBBB
BBBBPBBPBBBBBBBBBB
BBBBPPPPBBBBBBBBBB
BBBBBBBBBBBBBBBBBB
