22 16 1
BBBBBBBBBBBBBBBBBBBBBB
BSPPPPPPPPPPPPPPPPPPPB
BBBBBBBBBBPBBBBBBBBBPB
BPPPPPPPPPRPPPPPPPPBPB
BPBBBBBBBBPBBBBBBBPBPB
BPBPPPPPPPPPPPPPPBPBPB
BPBPBBBBBBPBBBBBPBPBPB
BPBPBPPPPPPPPPPBPBPBPB
BPBPBPBBBBPBBBABPBPBPB
BPBPBPBBBBPBBBBBPBPBPB
BPBPBPPPPPPPPPPPPBPBPB
BPBPBBBBBBPBBBBBBBPBPB
BPBPPPPPPPPPPPPPPPPBPB
BPBBBBBBBBPBBBBBBBBBPB
BPPPPPPPPPVPPPPPPPPPPB
BBBBBBBBBBBBBBBBBBBBBB