15 11 0
BBBBBBBBBBBBBBB
BBBBBVBPPPPPPPB
BBBBBPBPBBBBBPB
BBBBBPBPBAPPBPB
BBBBBPBPBBBPBPB
BBBBBPBPPPPPBPB
BBBBBPBBBBBBBPB
BSPPPPPPPPPPPPB
BBBBBPBBBBBBBBB
BBBBBPPPPPPPPRB
BBBBBBBBBBBBBBB